###########               ###
#         ### ############# #
# ####### ##   ##           #
#         ## ### ######### ##
########### # ##       #    #
#   ###     #B    ###### ####
# ###       # ##  ##     #   #
#   ####### ##     ## ## ## #
##      ##        ###     ## 
####   #######   ######   ##
#      #######  ###    #    #
##   ######### #########    #
#          ##   ######  ##  #
####### #     ###########  ##
#      ##                   #
###########################A#
