###########A##########
#                    #
# ### ### ########### #
# #   ##   ##         #
# # # # ###### ### # ##
# #     #          #  #
# ### ### ## ## ####  # 
# #       ##        #  #
# ### ### ##### ##### #
# #     #   ##  #     #
# ### ### ### # #####  #
#    #     #           #
######################B#